5 10
4 8
* * * * * * * * * *
*   o   *         *
*   *   *   * *   *
*   *       * *   *
* * * * * * * * o *

